WWWWWWWW
WFFFFFFW
WFFFFFWW
WFFFFFFW
WFFFFFFW
WFFFFFFW
WMMMWFFW
1FMMMMMW
WWFFFFFW
WFFFFFFW
WFFFFFFW
WFFFFFFW
WFFWWFFW
WFFFFFFW
WWWWWWWW

