WWWWWWW1WWWWW
WFFFFFFFFFFFW
WFFFFFFFFFWFW
WFFFFFWFFFFFW
WFFFFMFFFFFFW
WFFFFFFFFFFFW
WFFFFFFFWFFWW
WMFFFFFFFFFFW
WMMWWWWMMMMMW
WFMFFFFFFFFFW
WFFFFFFFFMFFW
WMFFFFFFFMMWW
WMFFFFFFFFFWW
WMFFFFFFFFFFW
WWWWWWWWWWWWW
