WWWXXXXWWW
WFFFFFFFFW
WFFFFFFFFW
WFFFFFFFFW
WFFTFFFFFW
WFFFWFFFFW
WFFFFFFFWW
1FFIIIFFF2
WFFIIIFFFW
WFFIIIFFFW
WFFTFFFFFW
WFFFFMFFFW
WFFFFFFFFW
WFFFFFFFFW
WFFFFFFFFW
WWWWWWWWWW