WWWWWWWWWW
WFFFFFFFFW
WFFFFFFFFW
WFFFFFFFFW
WFFFFFFFFW
WFFFWFFFFW
WFFFFFFFWW
1FFFFFFFF2
WFFFFFFFFW
WFFFFFFFFW
WFFFFFFFFW
WFFFFFFFFW
WFFFFFFFFW
WFFFFFFFFW
WFFFFFFFFW
WWWWWWWWWW
