WWWWWWWW
WFFFFFFW
WFFFFHWW
WFFFFFFW
WFFFFFEW
WFFFFFFW
2SFFWFFW
2FFFFFFW
WWFFFFFW
WFFFFFFW
WFFFFFFW
WFFFFFHW
WFFWWFFW
WFFFFFFW
WWWWWWWW