WWWWWWWWWW
WFSFFFFFFW
WFFFFFFFFW
WFFFFFFFFW
WFFFFFFFFW
WFFFWFFFFW
WHFFFFFFWW
WFFFFFFFFW
WFFFHFFFFW
WFFFFFFFFW
WFFFFFFFFW
WFFFFFFFFW
WFFFFFFFFW
WFFFFFEFFW
WFFFHFFFFW
WWWWWWWWWW

WWWWWWWWWWWWWWWW
WFFFFFFFWFFFFFFW
WFFFFFFFWFFFHFFW
WWFFFFFFFFFFFFFW
WFFFFFFFFFFFFFFW
WHFFFFFFWFFFFEHW
WFFWHFFFWFFFFFFW
WFFFFFFFWFFFFFFW
WFFFFFFFWFFFFFFW
WFFFFFFFWFFFFFFW
WFFWFFFFWFFFFFFW
WFFFFFFFWFFFFFFW
WFSFFFFFWFFFFFFW
WWWWWWWWWWWWWWWW

WWWWWWWW
WFFFFFFW
WFFFFHWW
WFFFFFFW
WFFFFFEW
WFFFFFFW
WFFFWFFW
WFFFFFFW
WWFFFFFW
WFFFFFFW
WSFFFFFW
WFFFFFHW
WFFWWFFW
WFFFFFFW
WWWWWWWW

WWWWWWWWWWWWW
WFFFFFFFHFFFW
WFFFFFFFFFWFW
WHFFFFWEFFFFW
WFFFFFFFFFFFW
WFFFFFFFFFFFW
WFFFFFFFWFFWW
WFFFFFFFFFFFW
WFFWWWWFFFFFW
WFFFFFFFFFFFW
WFFFHFFFFFHFW
WFFFFFFFFFFWW
WFFHFFFFFFFWW
WFFSFFFFFFFFW
WWWWWWWWWWWWW

WWWWWWWWWWWWW
WFSFFFFFWFWFW
WFFFFFHFFFHFW
WFWFFFFHFFFWW
WFFWFFFFFFFWW
WFFWFFFFWFWWW
WFFFFFFFFFFFW
WFFFEWFFFFFFW
WWWWWWWWWWWWW

WWWWWWWWWWW
WWFFFFFFWFW
WSFWFFFFFFW
WFFFFFHFFFW
WFFFFFFFFFW
WFFFHFFFFFW
WFFFFFWFFFW
WFFFFFFWEFW
WFFFHFFFWFW
WFFFFFWFFFW
WWWWWWWWWWW

WWWWWWWWWWWW
WFFSFWFFEFFW
WFFFFWFFFFFW
WFFFFWFFFFHW
WFFFFWFFFFFW
WFFFFWFFFFFW
WFFFFHFFFFWW
WFFFFWFFFFFW
WFFFFFFHFFFW
WFFFFFFFFFFW
WWWWWWWWWWWW

WWWWWWWWWWW
WFFEFFFFFFW
WFFWHFHFFFW
WFFFFWFFFFW
WFFFFFFFFFW
WFFFFWFFFFW
WFFFFWFFFFW
WFFFHFFFFFW
WFFFFFFFFFW
WWFFFHFFFFW
WFFFFFFFFHW
WFFFFFFFSFW
WWWWWWWWWWW

WWWWWWWWWWWWWWW
WFHWFFFFFFFFWFW
WFFFFHFFFFFFFFW
WFFFFFFFFFFFFFW
WFFFFFFFFFFFFFW
WWFFFFFFFFFFFFW
WFFFFFFFFFHFFFW
WFFFFFFFFFFFFFW
WFFFFFFFFFWFFSW
WFFFFFFFFFFFFFW
WFFFFWWWWWWWWHW
WFFFFFFFFFFFFFW
WFFFFFFFFHFFFFW
WFFFFFFFFFFFFFW
WFFFFFFFEFFFFFW
WWWWWWWWWWWWWWW

WWWWWWWWWWWW
WFFFFFFFFFFW
WFFFFFFFFFFW
WFSFWFFWFFHW
WWFFFFFFFFFW
WFFFFFFFFFFW
WFFFFFFFFFFW
WFWFFFWWWWWW
WFWFFFFFFFFW
WFFFFFFFFFFW
WFFFFWFFFFEW
WWWWWWWWWWWW

WWWWWWWWWWWW
WFFFFFFFFFFW
WFFFHFFHFFFW
WFFFFWFFFFFW
WWFFFFFEWFFW
WFFFFFFFFFFW
WFFFWFFFFFFW
WFFFWFFFWFFW
WFFFWWFFFFFW
WFFFFFFFFWFW
WFSFWFFFFFFW
WWWWWWWWWWWW

WWWWWWWWWWWW
WFFFFWFFFFWW
WFFFFFFFWFHW
WFFFFFFFFFFW
WFFFFEFWFFFW
WFFFFFFFFFFW
WFFFHHWWWFFW
WFFFFFFFWFFW
WWWWWWWWFFFW
WFFFFFFFFFFW
WWWFFWWWWWWW
WFFFFFFFFFFW
WFFFFFFFFFSW
WWWWWWWWWWWW

WWWWWWWWWWWWWW
WFFSWWFHFFFFWW
WFFFFFFWFFFFFW
WFFWWWWWWWWWFW
WFFFFFFFFFFFFW
WWWWWWWWWWWWFW
WFFFFHFFFFWFFW
WFFFFFFFFFFFFW
WFFFFWFFFFFFFW
WFFFEFFFWFFFFW
WWWWWWWWWWWWWW

WWWWWWWWWWWWWWW
WFFFFFFFFFFFFFW
WFFFWFWWFSFFFFW
WFFFFFFFFHHFFFW
WWFFFFFFFFFFFWW
WWFFFFHFFFWFFFW
WFFFFFFFFFFFFFW
WWWWWWWWWWFFFFW
WFFFFFFFFFFFFWW
WFFFFFFFFFFFFFW
WFFFFFFFFFFFFFW
WFFFFFFFFFFFFFW
WFFFFFFFFWFFFFW
WFFFFFFFHHFFFFW
WFFEFFFFFFWFFFW
WWWWWWWWWWWWWWW

WWWWWWWWW
WFFFFWFFW
WFFWFFFFW
WFFFFFFFW
WWFFFFFFW
WFFHEFFFW
WWFFFFFHW
WFFFWFFFW
WFFFFFFHW
WFFFFWFSW
WWWWWWWWW

WWWWWWWW
WFFFFFFW
WHFFFFFW
WWEFFFFW
WFFFFFFW
WFFFFFFW
WFFFFSFW
WHHFFFFW
WFFFFFFW
WFFFFFFW
WFFFFFFW
WFFFFFFW
WFFFFWFW
WFFFFFFW
WFFFFFFW
WWWWWWWW

WWWWWWWWWWWWW
WFFFWFFFFFFFW
WFFFFFFFHFWEW
WWFFFFFFWFFFW
WFFHHHFFFFFFW
WFWFFFHHWFFFW
WSFFFFFFFFFHW
WWWWWWWWWWWWW

WWWWWWWWWW
WFFFWFFFFW
WFFWFFFFFW
WFFFFFEFFW
WFFFFFFFFW
WWFWFFFFFW
WWFFFFFFFW
WFWFFFSFWW
WFFFFHFFFW
WFFWFFFFWW
WWWWWWWWWW

WWWWWWWWWWW
WSFFFFWFFWW
WFFFFHFFFFW
WFFFHFFFWFW
WFFFFFFFFFW
WFFFFFFFFFW
WFFWWFFFEWW
WFFFFHFFWFW
WFFFFFFHFFW
WWWWWWWWWWW

WWWWWWWWWWWWW
WFFWEFFFFFFFW
WFFFFFHFFFFFW
WFFFFFFFFSFFW
WFFFWFFFFFFFW
WFFFFFFFFFFFW
WFFFFFFFFFFFW
WFFFFFFFFFFFW
WFFFFFFFFFFFW
WFFFFFFFFFFWW
WFFFFFWFFFFFW
WFFFWWFFFFFFW
WWWWWWWWWWWWW

WWWWWWWWWWWWWWW
WHFFFFFFFFHHFFW
WFWFFFFFFFFSFFW
WFFFFFFFFFFFFFW
WFWFFFFFFFWFFFW
WFFFFFFFFFFFFFW
WFFFFFFFFFFFFFW
WFFFFFFFFFFFFFW
WEFFFFFFFFFFFFW
WFFFFFFFFFFFFFW
WWWWWWWWWWWWWWW

WWWWWWWWWWWWW
WEWFFFFFFFFFW
WFFFFFFFFFFFW
WFFHFFFFFFFFW
WFFFFFHSFFFFW
WFFFFFFFFFHFW
WFFFFFFFFHHFW
WWWWWWWWWWWWW

WWWWWWWWWWWWWW
WFFFWFFFFFFFFW
WFFFFFFFFFFFFW
WFFFFFFFFFFFFW
WFFFFFFFFFFFFW
WFFFFFFFFFHFFW
WFFFFFHFFFFFFW
WFFFFFFFFFFFFW
WFSFFWFFFFFFFW
WFFFFFFFFFFFFW
WFFFFFFFFFFFFW
WFFFFFFWFFFWWW
WHFFFFFFFFFFFW
WFFFFEFWFFFFFW
WFFFFFFFFFWFFW
WWWWWWWWWWWWWW

WWWWWWWWWWWWWWWW
WFWFFFFFFFFFFFFW
WFFFFFFFFFFFFFFW
WFFFFFFFFFFFFFFW
WFFFFFFFFFFSFFFW
WFFWFFFFFWFFFFFW
WFFFFFFFFFFHFFFW
WFFFFFFFFFFFFFWW
WFFFHFFEFFFFFFFW
WFFFFFFFFWFFFFFW
WWWWWWWWWWWWWWWW

WWWWWWWWWW
WFFFFFFFFW
WFFFFFFEFW
WHFFFFFFWW
WFFFFFFFFW
WFFFFFWFFW
WFFFFFFFFW
WFSFFFHFFW
WWFFFFFFFW
WWWWWWWWWW
