WWWWWWWWWWWWWWWW
WFFFFFFFWFFFFFFW
WFFFFFFFWFFFFFFW
WWFFFFFFFFFFFFFW
WFFFFFFFFFFFFFFW
WFFFFFFFWFFFFFFW
WFFWFFFFWFFFFFFW
WFFFFFFFWFFFFFF1
WFFFFFFFWFFFFFFW
WFFFFFFFWFFFFFFW
WFFWFFFFWFFFFFFW
WFFFFFFFWFFFFFFW
WFFFFFFFWFFFFFFW
WWWWWWW2WWWWWWWW
